Erde	Wiki.location
Europäische Union	Wiki.location
Afrikanische Union	Wiki.location
Organisation Amerikanischer Staaten	Wiki.location
Pazifisches Inselforum	Wiki.location
Abchasien	Wiki.location
Afghanistan	Wiki.location
Ägypten	Wiki.location
Albanien	Wiki.location
Algerien	Wiki.location
Andorra	Wiki.location
Angola	Wiki.location
Antigua und Barbuda	Wiki.location
Äquatorialguinea	Wiki.location
Argentinien	Wiki.location
Armenien	Wiki.location
Aserbaidschan	Wiki.location
Äthiopien	Wiki.location
Australien	Wiki.location
Bahamas	Wiki.location
Bahrain	Wiki.location
Bangladesch	Wiki.location
Barbados	Wiki.location
Belgien	Wiki.location
Belize	Wiki.location
Benin	Wiki.location
Bergkarabach	Wiki.location
Bhutan	Wiki.location
Bolivien	Wiki.location
Bosnien und Herzegowina	Wiki.location
Botswana	Wiki.location
Brasilien	Wiki.location
Brunei	Wiki.location
Bulgarien	Wiki.location
Burkina Faso	Wiki.location
Burundi	Wiki.location
Chile	Wiki.location
Republik China	Wiki.location
Volksrepublik China	Wiki.location
mit Hongkong (HK) undMacau (MO)Cookinseln	Wiki.location
Costa Rica	Wiki.location
Dänemark	Wiki.location
mit Färöer (FO) undGrönland (GL)	Wiki.location
Deutschland	Wiki.location
Dominica	Wiki.location
Dominikanische Republik	Wiki.location
Dschibuti	Wiki.location
Ecuador	Wiki.location
El Salvador	Wiki.location
Elfenbeinküste	Wiki.location
Eritrea	Wiki.location
Estland	Wiki.location
Fidschi	Wiki.location
Finnland	Wiki.location
Frankreich	Wiki.location
ohne Überseegebiete	Wiki.location
Gabun	Wiki.location
Gambia	Wiki.location
Georgien	Wiki.location
mit Abchasien undSüdossetien	Wiki.location
Ghana	Wiki.location
Grenada	Wiki.location
Griechenland	Wiki.location
Guatemala	Wiki.location
Guinea	Wiki.location
Guinea-Bissau	Wiki.location
Guyana	Wiki.location
Haiti	Wiki.location
Honduras	Wiki.location
Indien	Wiki.location
mit Kaschmir	Wiki.location
Indonesien	Wiki.location
Irak	Wiki.location
Iran	Wiki.location
IrlandIsland	Wiki.location
Israel	Wiki.location
mit Golanhöhen undOstjerusalem,	Wiki.location
ohne Gazastreifen undWestjordanland	Wiki.location
Italien	Wiki.location
Jamaika	Wiki.location
Japan	Wiki.location
Jemen	Wiki.location
Jordanien	Wiki.location
Kambodscha	Wiki.location
Kamerun	Wiki.location
Kanada	Wiki.location
Kap Verde	Wiki.location
Kasachstan	Wiki.location
Katar	Wiki.location
Kenia	Wiki.location
KirgisistanKiribati	Wiki.location
Kolumbien	Wiki.location
Komoren	Wiki.location
Kongo, Demokratische Republik	Wiki.location
Kongo, Republik	Wiki.location
Korea, Nord	Wiki.location
Korea, Süd	Wiki.location
Kosovo	Wiki.location
KroatienKuba	Wiki.location
Kuwait	Wiki.location
Laos	Wiki.location
Lesotho	Wiki.location
Lettland	Wiki.location
Libanon	Wiki.location
Liberia	Wiki.location
Libyen	Wiki.location
Liechtenstein	Wiki.location
LitauenLuxemburg	Wiki.location
Madagaskar	Wiki.location
Malawi	Wiki.location
Malaysia	Wiki.location
Malediven	Wiki.location
Mali	Wiki.location
Malta	Wiki.location
Marokko	Wiki.location
ohne Westsahara (EH)	Wiki.location
Marshallinseln	Wiki.location
Mauretanien	Wiki.location
Mauritius	Wiki.location
Mazedonien	Wiki.location
Mexiko	Wiki.location
Mikronesien	Wiki.location
Moldawien	Wiki.location
mit Transnistrien	Wiki.location
Monaco	Wiki.location
Mongolei	Wiki.location
Montenegro	Wiki.location
Mosambik	Wiki.location
Myanmar	Wiki.location
Namibia	Wiki.location
Nauru	Wiki.location
Nepal	Wiki.location
NeuseelandNicaragua	Wiki.location
Niederlande	Wiki.location
ohne Aruba (AW),	Wiki.location
Curaçao (CW) und	Wiki.location
Sint Maarten (SX)	Wiki.location
Niger	Wiki.location
Nigeria	Wiki.location
Niue	Wiki.location
Nordzypern	Wiki.location
Norwegen	Wiki.location
ohne Svalbard (SJ)	Wiki.location
Oman	Wiki.location
Österreich	Wiki.location
Osttimor / Timor-LestePakistan	Wiki.location
ohne Kaschmir	Wiki.location
PalästinaPalau	Wiki.location
Panama	Wiki.location
Papua-Neuguinea	Wiki.location
ParaguayPeru	Wiki.location
Philippinen	Wiki.location
Polen	Wiki.location
Portugal	Wiki.location
Ruanda	Wiki.location
Rumänien	Wiki.location
Russland	Wiki.location
ohne Krim	Wiki.location
Salomonen	Wiki.location
Sambia	Wiki.location
Samoa	Wiki.location
San Marino	Wiki.location
São Tomé und Príncipe	Wiki.location
Saudi-Arabien	Wiki.location
Schweden	Wiki.location
SchweizSenegal	Wiki.location
Serbien	Wiki.location
ohne Kosovo	Wiki.location
Seychellen	Wiki.location
Sierra Leone	Wiki.location
Simbabwe	Wiki.location
Singapur	Wiki.location
SlowakeiSlowenienSomalia	Wiki.location
mit Somaliland	Wiki.location
Somaliland	Wiki.location
Spanien	Wiki.location
Sri Lanka	Wiki.location
St. Kitts und Nevis	Wiki.location
St. Lucia	Wiki.location
St. Vincent und die Grenadinen	Wiki.location
SüdafrikaSudan	Wiki.location
Südossetien	Wiki.location
Südsudan	Wiki.location
Suriname	Wiki.location
Swasiland	Wiki.location
Syrien	Wiki.location
mit Golanhöhen	Wiki.location
Tadschikistan	Wiki.location
Tansania	Wiki.location
Thailand	Wiki.location
Togo	Wiki.location
Tonga	Wiki.location
Transnistrien	Wiki.location
Trinidad und Tobago	Wiki.location
Tschad	Wiki.location
Tschechien	Wiki.location
Tunesien	Wiki.location
Türkei	Wiki.location
Turkmenistan	Wiki.location
Tuvalu	Wiki.location
Uganda	Wiki.location
Ukraine	Wiki.location
Krim	Wiki.location
Ungarn	Wiki.location
Uruguay	Wiki.location
Usbekistan	Wiki.location
Vanuatu	Wiki.location
Vatikanstadt	Wiki.location
Venezuela	Wiki.location
Vereinigte Arabische Emirate	Wiki.location
Vereinigte Staaten	Wiki.location
Vereinigtes Königreich	Wiki.location
Vietnam	Wiki.location
Weißrussland	Wiki.location
Westsahara	Wiki.location
Zentralafrikanische Republik	Wiki.location
Zypern	Wiki.location
Nordzypern	Wiki.location
Deutsche Postbank	Wiki.org
Klöckner & Co	Wiki.org
Freenet AG	Wiki.org
Tognum	Wiki.org
Rheinmetall	Wiki.org
Allianz SE	Wiki.org
Volkswagen AG	Wiki.org
E.ON	Wiki.org
Daimler AG	Wiki.org
Siemens AG	Wiki.org
Deutsche Bank	Wiki.org
BMW	Wiki.org
BASF	Wiki.org
Deutsche Telekom	Wiki.org
RWE	Wiki.org
Munich Re	Wiki.org
Bayer AG	Wiki.org
Deutsche Post AG	Wiki.org
Metro AG	Wiki.org
ThyssenKrupp	Wiki.org
Commerzbank	Wiki.org
SAP	Wiki.org
Linde AG	Wiki.org
EnBW	Wiki.org
Henkel Group	Wiki.org
Continental AG	Wiki.org
Deutsche Lufthansa	Wiki.org
Fresenius SE & Co. KGaA	Wiki.org
MAN	Wiki.org
Merck KGaA	Wiki.org
Hannover Rück	Wiki.org
adidas	Wiki.org
Deutsche Börse	Wiki.org
Hochtief	Wiki.org
HeidelbergCement	Wiki.org
Landesbank Berlin	Wiki.org
Wüstenrot & Württembergische	Wiki.org
K+S	Wiki.org
Beiersdorf AG	Wiki.org
Infineon	Wiki.org
Porsche	Wiki.org
TUI	Wiki.org
Bilfinger Berger	Wiki.org
Celesio	Wiki.org
Nürnberger Beteiligungs-AG	Wiki.org
Aurubis	Wiki.org
Südzucker	Wiki.org
ProSiebenSat.1 Media	Wiki.org
Fraport	Wiki.org
Salzgitter AG	Wiki.org
Wacker Chemie	Wiki.org
Aareal Bank	Wiki.org
IKB Deutsche Industriebank	Wiki.org
Brenntag	Wiki.org
Lanxess	Wiki.org
DVB Bank	Wiki.org
BayWa	Wiki.org
GEA Group	Wiki.org
Axel Springer AG	Wiki.org
Aach	Wiki.city
Aachen	Wiki.city
Aalen	Wiki.city
Abenberg	Wiki.city
Abensberg	Wiki.city
Achern	Wiki.city
Achim	Wiki.city
Adelsheim	Wiki.city
Adenau	Wiki.city
Adorf/Vogtl.	Wiki.city
Ahaus	Wiki.city
Ahlen	Wiki.city
Ahrensburg	Wiki.city
Aichach	Wiki.city
Aichtal	Wiki.city
Aken	Wiki.city
Albstadt	Wiki.city
Alfeld	Wiki.city
Allendorf	Wiki.city
Allstedt	Wiki.city
Alpirsbach	Wiki.city
Alsdorf	Wiki.city
Alsfeld	Wiki.city
Alsleben	Wiki.city
Altdorf bei Nürnberg	Wiki.city
Altena	Wiki.city
Altenberg	Wiki.city
Altenburg	Wiki.city
Altenkirchen	Wiki.city
Altensteig	Wiki.city
Altentreptow	Wiki.city
Altlandsberg	Wiki.city
Altötting	Wiki.city
Alzenau	Wiki.city
Alzey	Wiki.city
Amberg	Wiki.city
Amöneburg	Wiki.city
Amorbach	Wiki.city
Andernach	Wiki.city
Angermünde	Wiki.city
Anklam, Hansestadt	Wiki.city
Annaberg-Buchholz	Wiki.city
Annaburg	Wiki.city
Annweiler am Trifels	Wiki.city
Ansbach	Wiki.city
Apolda	Wiki.city
Arendsee	Wiki.city
Arneburg	Wiki.city
Arnis	Wiki.city
Arnsberg	Wiki.city
Arnstadt	Wiki.city
Arnstein	Wiki.city
Arnstein	Wiki.city
Artern/Unstrut	Wiki.city
Arzberg	Wiki.city
Aschaffenburg	Wiki.city
Aschersleben	Wiki.city
Asperg	Wiki.city
Aßlar	Wiki.city
Attendorn	Wiki.city
Aub	Wiki.city
Aue	Wiki.city
Auerbach in der Oberpfalz	Wiki.city
Auerbach/Vogtl.	Wiki.city
Augsburg	Wiki.city
Augustusburg	Wiki.city
Aulendorf	Wiki.city
Auma-Weidatal	Wiki.city
Aurich	Wiki.city
Babenhausen	Wiki.city
Bacharach	Wiki.city
Backnang	Wiki.city
Bad Aibling	Wiki.city
Bad Arolsen	Wiki.city
Bad Belzig	Wiki.city
Bad Bentheim	Wiki.city
Bad Bergzabern	Wiki.city
Bad Berka	Wiki.city
Bad Berleburg	Wiki.city
Bad Berneck im Fichtelgebirge	Wiki.city
Bad Bevensen	Wiki.city
Bad Bibra	Wiki.city
Bad Blankenburg	Wiki.city
Bad Bramstedt	Wiki.city
Bad Breisig	Wiki.city
Bad Brückenau	Wiki.city
Bad Buchau	Wiki.city
Bad Camberg	Wiki.city
Bad Colberg-Heldburg	Wiki.city
Bad Doberan	Wiki.city
Bad Driburg	Wiki.city
Bad Düben	Wiki.city
Bad Dürkheim	Wiki.city
Bad Dürrenberg	Wiki.city
Bad Dürrheim	Wiki.city
Bad Elster	Wiki.city
Bad Ems	Wiki.city
Baden-Baden	Wiki.city
Bad Fallingbostel	Wiki.city
Bad Frankenhausen/Kyffhäuser	Wiki.city
Bad Freienwalde	Wiki.city
Bad Friedrichshall	Wiki.city
Bad Gandersheim	Wiki.city
Bad Gottleuba-Berggießhübel	Wiki.city
Bad Griesbach im Rottal	Wiki.city
Bad Harzburg	Wiki.city
Bad Herrenalb	Wiki.city
Bad Hersfeld	Wiki.city
Bad Homburg vor der Höhe	Wiki.city
Bad Honnef	Wiki.city
Bad Hönningen	Wiki.city
Bad Iburg	Wiki.city
Bad Karlshafen	Wiki.city
Bad Kissingen	Wiki.city
Bad König	Wiki.city
Bad Königshofen im Grabfeld	Wiki.city
Bad Köstritz	Wiki.city
Bad Kötzting	Wiki.city
Bad Kreuznach	Wiki.city
Bad Krozingen	Wiki.city
Bad Laasphe	Wiki.city
Bad Langensalza	Wiki.city
Bad Lauchstädt	Wiki.city
Bad Lausick	Wiki.city
Bad Lauterberg im Harz	Wiki.city
Bad Liebenstein	Wiki.city
Bad Liebenwerda	Wiki.city
Bad Liebenzell	Wiki.city
Bad Lippspringe	Wiki.city
Bad Lobenstein	Wiki.city
Bad Marienberg	Wiki.city
Bad Mergentheim	Wiki.city
Bad Münder am Deister	Wiki.city
Bad Münstereifel	Wiki.city
Bad Muskau	Wiki.city
Bad Nauheim	Wiki.city
Bad Nenndorf	Wiki.city
Bad Neuenahr-Ahrweiler	Wiki.city
Bad Neustadt an der Saale	Wiki.city
Bad Oeynhausen	Wiki.city
Bad Oldesloe	Wiki.city
Bad Orb	Wiki.city
Bad Pyrmont	Wiki.city
Bad Rappenau	Wiki.city
Bad Reichenhall	Wiki.city
Bad Rodach	Wiki.city
Bad Sachsa	Wiki.city
Bad Säckingen	Wiki.city
Bad Salzdetfurth	Wiki.city
Bad Salzuflen	Wiki.city
Bad Salzungen	Wiki.city
Bad Saulgau	Wiki.city
Bad Schandau	Wiki.city
Bad Schmiedeberg	Wiki.city
Bad Schussenried	Wiki.city
Bad Schwalbach	Wiki.city
Bad Schwartau	Wiki.city
Bad Segeberg	Wiki.city
Bad Sobernheim	Wiki.city
Bad Soden am Taunus	Wiki.city
Bad Soden-Salmünster	Wiki.city
Bad Sooden-Allendorf	Wiki.city
Bad Staffelstein	Wiki.city
Bad Sulza	Wiki.city
Bad Sülze	Wiki.city
Bad Teinach-Zavelstein	Wiki.city
Bad Tennstedt	Wiki.city
Bad Tölz	Wiki.city
Bad Urach	Wiki.city
Bad Vilbel	Wiki.city
Bad Waldsee	Wiki.city
Bad Wildbad	Wiki.city
Bad Wildungen	Wiki.city
Bad Wilsnack	Wiki.city
Bad Wimpfen	Wiki.city
Bad Windsheim	Wiki.city
Bad Wörishofen	Wiki.city
Bad Wünnenberg	Wiki.city
Bad Wurzach	Wiki.city
Baesweiler	Wiki.city
Baiersdorf	Wiki.city
Balingen	Wiki.city
Ballenstedt	Wiki.city
Balve	Wiki.city
Bamberg	Wiki.city
Barby	Wiki.city
Bargteheide	Wiki.city
Barmstedt	Wiki.city
Bärnau	Wiki.city
Barntrup	Wiki.city
Barsinghausen	Wiki.city
Barth	Wiki.city
Baruth/Mark	Wiki.city
Bassum	Wiki.city
Battenberg	Wiki.city
Baumholder	Wiki.city
Baunach	Wiki.city
Baunatal	Wiki.city
Bautzen	Wiki.city
Bayreuth	Wiki.city
Bebra	Wiki.city
Beckum	Wiki.city
Bedburg	Wiki.city
Beelitz	Wiki.city
Beerfelden	Wiki.city
Beeskow	Wiki.city
Beilngries	Wiki.city
Beilstein	Wiki.city
Belgern-Schildau	Wiki.city
Bendorf	Wiki.city
Bensheim	Wiki.city
Berching	Wiki.city
Berga/Elster	Wiki.city
Bergen	Wiki.city
Bergen auf Rügen	Wiki.city
Bergheim	Wiki.city
Bergisch Gladbach	Wiki.city
Bergkamen	Wiki.city
Bergneustadt	Wiki.city
Berka/Werra	Wiki.city
Berlin	Wiki.city
Bernau bei Berlin	Wiki.city
Bernburg	Wiki.city
Bernkastel-Kues	Wiki.city
Bernsdorf	Wiki.city
Bernstadt a. d. Eigen	Wiki.city
Bersenbrück	Wiki.city
Besigheim	Wiki.city
Betzdorf	Wiki.city
Betzenstein	Wiki.city
Beverungen	Wiki.city
Bexbach	Wiki.city
Biberach an der Riß	Wiki.city
Biedenkopf	Wiki.city
Bielefeld	Wiki.city
Biesenthal	Wiki.city
Bietigheim-Bissingen	Wiki.city
Billerbeck	Wiki.city
Bingen am Rhein	Wiki.city
Birkenfeld	Wiki.city
Bischofsheim an der Rhön	Wiki.city
Bischofswerda	Wiki.city
Bismark	Wiki.city
Bitburg	Wiki.city
Bitterfeld-Wolfen	Wiki.city
Blankenburg	Wiki.city
Blankenhain	Wiki.city
Blaubeuren	Wiki.city
Blaustein	Wiki.city
Bleckede	Wiki.city
Bleicherode	Wiki.city
Blieskastel	Wiki.city
Blomberg	Wiki.city
Blumberg	Wiki.city
Bobingen	Wiki.city
Böblingen	Wiki.city
Bocholt	Wiki.city
Bochum	Wiki.city
Bockenem	Wiki.city
Bodenwerder	Wiki.city
Bogen	Wiki.city
Böhlen	Wiki.city
Boizenburg/Elbe	Wiki.city
Bonn	Wiki.city
Bonndorf im Schwarzwald	Wiki.city
Bönnigheim	Wiki.city
Bopfingen	Wiki.city
Boppard	Wiki.city
Borgentreich	Wiki.city
Borgholzhausen	Wiki.city
Borken	Wiki.city
Borken	Wiki.city
Borkum	Wiki.city
Borna	Wiki.city
Bornheim	Wiki.city
Bottrop	Wiki.city
Boxberg	Wiki.city
Brackenheim	Wiki.city
Brake	Wiki.city
Brakel	Wiki.city
Bramsche	Wiki.city
Brandenburg an der Havel	Wiki.city
Brand-Erbisdorf	Wiki.city
Brandis	Wiki.city
Braubach	Wiki.city
Braunfels	Wiki.city
Braunlage	Wiki.city
Bräunlingen	Wiki.city
Braunsbedra	Wiki.city
Braunschweig	Wiki.city
Breckerfeld	Wiki.city
Bredstedt	Wiki.city
Breisach am Rhein	Wiki.city
Bremen, Freie Hansestadt	Wiki.city
Bremerhaven	Wiki.city
Bremervörde	Wiki.city
Bretten	Wiki.city
Breuberg	Wiki.city
Brilon	Wiki.city
Brotterode-Trusetal	Wiki.city
Bruchköbel	Wiki.city
Bruchsal	Wiki.city
Brück	Wiki.city
Brüel	Wiki.city
Brühl	Wiki.city
Brunsbüttel	Wiki.city
Brüssow	Wiki.city
Buchen	Wiki.city
Buchholz in der Nordheide	Wiki.city
Buchloe	Wiki.city
Bückeburg	Wiki.city
Buckow	Wiki.city
Büdelsdorf	Wiki.city
Büdingen	Wiki.city
Bühl	Wiki.city
Bünde	Wiki.city
Büren	Wiki.city
Burg	Wiki.city
Burgau	Wiki.city
Burgbernheim	Wiki.city
Burgdorf	Wiki.city
Bürgel	Wiki.city
Burghausen	Wiki.city
Burgkunstadt	Wiki.city
Burglengenfeld	Wiki.city
Burgstädt	Wiki.city
Burg Stargard	Wiki.city
Burgwedel	Wiki.city
Burladingen	Wiki.city
Burscheid	Wiki.city
Bürstadt	Wiki.city
Buttelstedt	Wiki.city
Buttstädt	Wiki.city
Butzbach	Wiki.city
Bützow	Wiki.city
Buxtehude	Wiki.city
Calau	Wiki.city
Calbe	Wiki.city
Calw	Wiki.city
Castrop-Rauxel	Wiki.city
Celle	Wiki.city
Cham	Wiki.city
Chemnitz	Wiki.city
Clausthal-Zellerfeld	Wiki.city
Clingen	Wiki.city
Cloppenburg	Wiki.city
Coburg	Wiki.city
Cochem	Wiki.city
Coesfeld	Wiki.city
Colditz	Wiki.city
Coswig	Wiki.city
Coswig	Wiki.city
Cottbus	Wiki.city
Crailsheim	Wiki.city
Creglingen	Wiki.city
Creußen	Wiki.city
Creuzburg	Wiki.city
Crimmitschau	Wiki.city
Crivitz	Wiki.city
Cuxhaven	Wiki.city
Dachau	Wiki.city
Dahlen	Wiki.city
Dahme/Mark	Wiki.city
Dahn	Wiki.city
Damme	Wiki.city
Dannenberg	Wiki.city
Dargun	Wiki.city
Darmstadt	Wiki.city
Dassel	Wiki.city
Dassow	Wiki.city
Datteln	Wiki.city
Daun	Wiki.city
Deggendorf	Wiki.city
Deidesheim	Wiki.city
Delbrück	Wiki.city
Delitzsch	Wiki.city
Delmenhorst	Wiki.city
Demmin, Hansestadt	Wiki.city
Dessau-Roßlau	Wiki.city
Detmold	Wiki.city
Dettelbach	Wiki.city
Dieburg	Wiki.city
Diemelstadt	Wiki.city
Diepholz	Wiki.city
Dierdorf	Wiki.city
Dietenheim	Wiki.city
Dietfurt an der Altmühl	Wiki.city
Dietzenbach	Wiki.city
Diez	Wiki.city
Dillenburg	Wiki.city
Dillingen an der Donau	Wiki.city
Dillingen/Saar	Wiki.city
Dingelstädt	Wiki.city
Dingolfing	Wiki.city
Dinkelsbühl	Wiki.city
Dinklage	Wiki.city
Dinslaken	Wiki.city
Dippoldiswalde	Wiki.city
Dissen am Teutoburger Wald	Wiki.city
Ditzingen	Wiki.city
Döbeln	Wiki.city
Doberlug-Kirchhain	Wiki.city
Döbern	Wiki.city
Dohna	Wiki.city
Dömitz	Wiki.city
Dommitzsch	Wiki.city
Donaueschingen	Wiki.city
Donauwörth	Wiki.city
Donzdorf	Wiki.city
Dorfen	Wiki.city
Dormagen	Wiki.city
Dornburg-Camburg	Wiki.city
Dornhan	Wiki.city
Dornstetten	Wiki.city
Dorsten	Wiki.city
Dortmund	Wiki.city
Dransfeld	Wiki.city
Drebkau	Wiki.city
Dreieich	Wiki.city
Drensteinfurt	Wiki.city
Dresden	Wiki.city
Drolshagen	Wiki.city
Duderstadt	Wiki.city
Duisburg	Wiki.city
Dülmen	Wiki.city
Düren	Wiki.city
Düsseldorf	Wiki.city
Ebeleben	Wiki.city
Eberbach	Wiki.city
Ebermannstadt	Wiki.city
Ebern	Wiki.city
Ebersbach an der Fils	Wiki.city
Ebersbach-Neugersdorf	Wiki.city
Ebersberg	Wiki.city
Eberswalde	Wiki.city
Eckartsberga	Wiki.city
Eckernförde	Wiki.city
Edenkoben	Wiki.city
Egeln	Wiki.city
Eggenfelden	Wiki.city
Eggesin	Wiki.city
Ehingen	Wiki.city
Ehrenfriedersdorf	Wiki.city
Eibelstadt	Wiki.city
Eibenstock	Wiki.city
Eichstätt	Wiki.city
Eilenburg	Wiki.city
Einbeck	Wiki.city
Eisenach	Wiki.city
Eisenberg	Wiki.city
Eisenberg	Wiki.city
Eisenhüttenstadt	Wiki.city
Eisfeld	Wiki.city
Eisleben, Lutherstadt	Wiki.city
Eislingen/Fils	Wiki.city
Ellingen	Wiki.city
Ellrich	Wiki.city
Ellwangen	Wiki.city
Elmshorn	Wiki.city
Elsdorf	Wiki.city
Elsfleth	Wiki.city
Elsterberg	Wiki.city
Elsterwerda	Wiki.city
Elstra	Wiki.city
Elterlein	Wiki.city
Eltmann	Wiki.city
Eltville am Rhein	Wiki.city
Elzach	Wiki.city
Elze	Wiki.city
Emden	Wiki.city
Emmelshausen	Wiki.city
Emmendingen	Wiki.city
Emmerich am Rhein	Wiki.city
Emsdetten	Wiki.city
Endingen am Kaiserstuhl	Wiki.city
Engen	Wiki.city
Enger	Wiki.city
Ennepetal	Wiki.city
Ennigerloh	Wiki.city
Eppelheim	Wiki.city
Eppingen	Wiki.city
Eppstein	Wiki.city
Erbach	Wiki.city
Erbach	Wiki.city
Erbendorf	Wiki.city
Erding	Wiki.city
Erftstadt	Wiki.city
Erfurt	Wiki.city
Erkelenz	Wiki.city
Erkner	Wiki.city
Erkrath	Wiki.city
Erlangen	Wiki.city
Erlenbach am Main	Wiki.city
Erlensee	Wiki.city
Erwitte	Wiki.city
Eschborn	Wiki.city
Eschenbach in der Oberpfalz	Wiki.city
Eschershausen	Wiki.city
Eschwege	Wiki.city
Eschweiler	Wiki.city
Esens	Wiki.city
Espelkamp	Wiki.city
Essen	Wiki.city
Esslingen am Neckar	Wiki.city
Ettenheim	Wiki.city
Ettlingen	Wiki.city
Euskirchen	Wiki.city
Eutin	Wiki.city
Falkenberg/Elster	Wiki.city
Falkensee	Wiki.city
Falkenstein/Harz	Wiki.city
Falkenstein/Vogtl.	Wiki.city
Fehmarn	Wiki.city
Fellbach	Wiki.city
Felsberg	Wiki.city
Feuchtwangen	Wiki.city
Filderstadt	Wiki.city
Finsterwalde	Wiki.city
Fladungen	Wiki.city
Flensburg	Wiki.city
Flöha	Wiki.city
Flörsheim am Main	Wiki.city
Florstadt	Wiki.city
Forchheim	Wiki.city
Forchtenberg	Wiki.city
Forst	Wiki.city
Frankenau	Wiki.city
Frankenberg	Wiki.city
Frankenberg/Sa.	Wiki.city
Frankenthal	Wiki.city
Frankfurt am Main	Wiki.city
Frankfurt	Wiki.city
Franzburg	Wiki.city
Frauenstein	Wiki.city
Frechen	Wiki.city
Freiberg am Neckar	Wiki.city
Freiberg	Wiki.city
Freiburg im Breisgau	Wiki.city
Freilassing	Wiki.city
Freinsheim	Wiki.city
Freising	Wiki.city
Freital	Wiki.city
Freren	Wiki.city
Freudenberg	Wiki.city
Freudenberg	Wiki.city
Freudenstadt	Wiki.city
Freyburg	Wiki.city
Freystadt	Wiki.city
Freyung	Wiki.city
Fridingen an der Donau	Wiki.city
Friedberg	Wiki.city
Friedberg	Wiki.city
Friedland	Wiki.city
Friedland	Wiki.city
Friedrichroda	Wiki.city
Friedrichsdorf	Wiki.city
Friedrichshafen	Wiki.city
Friedrichstadt	Wiki.city
Friedrichsthal	Wiki.city
Friesack	Wiki.city
Friesoythe	Wiki.city
Fritzlar	Wiki.city
Frohburg	Wiki.city
Fröndenberg/Ruhr	Wiki.city
Fulda	Wiki.city
Fürstenau	Wiki.city
Fürstenberg/Havel	Wiki.city
Fürstenfeldbruck	Wiki.city
Fürstenwalde/Spree	Wiki.city
Fürth	Wiki.city
Furth im Wald	Wiki.city
Furtwangen im Schwarzwald	Wiki.city
Füssen	Wiki.city
Gadebusch	Wiki.city
Gaggenau	Wiki.city
Gaildorf	Wiki.city
Gammertingen	Wiki.city
Garbsen	Wiki.city
Garching bei München	Wiki.city
Gardelegen	Wiki.city
Garding	Wiki.city
Gartz	Wiki.city
Garz/Rügen	Wiki.city
Gau-Algesheim	Wiki.city
Gebesee	Wiki.city
Gedern	Wiki.city
Geesthacht	Wiki.city
Geestland	Wiki.city
Gefell	Wiki.city
Gefrees	Wiki.city
Gehrden	Wiki.city
Gehren	Wiki.city
Geilenkirchen	Wiki.city
Geisa	Wiki.city
Geiselhöring	Wiki.city
Geisenfeld	Wiki.city
Geisenheim	Wiki.city
Geisingen	Wiki.city
Geislingen	Wiki.city
Geislingen an der Steige	Wiki.city
Geithain	Wiki.city
Geldern	Wiki.city
Gelnhausen	Wiki.city
Gelsenkirchen	Wiki.city
Gemünden am Main	Wiki.city
Gemünden	Wiki.city
Gengenbach	Wiki.city
Genthin	Wiki.city
Georgsmarienhütte	Wiki.city
Gera	Wiki.city
Gerabronn	Wiki.city
Gerbstedt	Wiki.city
Geretsried	Wiki.city
Geringswalde	Wiki.city
Gerlingen	Wiki.city
Germering	Wiki.city
Germersheim	Wiki.city
Gernsbach	Wiki.city
Gernsheim	Wiki.city
Gerolstein	Wiki.city
Gerolzhofen	Wiki.city
Gersfeld	Wiki.city
Gersthofen	Wiki.city
Gescher	Wiki.city
Geseke	Wiki.city
Gevelsberg	Wiki.city
Geyer	Wiki.city
Giengen an der Brenz	Wiki.city
Gießen	Wiki.city
Gifhorn	Wiki.city
Ginsheim-Gustavsburg	Wiki.city
Gladbeck	Wiki.city
Gladenbach	Wiki.city
Glashütte	Wiki.city
Glauchau	Wiki.city
Glinde	Wiki.city
Glücksburg	Wiki.city
Glückstadt	Wiki.city
Gnoien	Wiki.city
Goch	Wiki.city
Goldberg	Wiki.city
Goldkronach	Wiki.city
Golßen	Wiki.city
Gommern	Wiki.city
Göppingen	Wiki.city
Görlitz	Wiki.city
Goslar	Wiki.city
Gößnitz	Wiki.city
Gotha	Wiki.city
Göttingen	Wiki.city
Grabow	Wiki.city
Grafenau	Wiki.city
Gräfenberg	Wiki.city
Gräfenhainichen	Wiki.city
Gräfenthal	Wiki.city
Grafenwöhr	Wiki.city
Grafing bei München	Wiki.city
Gransee	Wiki.city
Grebenau	Wiki.city
Grebenstein	Wiki.city
Greding	Wiki.city
Greifswald, Hansestadt	Wiki.city
Greiz	Wiki.city
Greußen	Wiki.city
Greven	Wiki.city
Grevenbroich	Wiki.city
Grevesmühlen	Wiki.city
Griesheim	Wiki.city
Grimma	Wiki.city
Grimmen	Wiki.city
Gröditz	Wiki.city
Groitzsch	Wiki.city
Gronau	Wiki.city
Gronau (Westf.)	Wiki.city
Gröningen	Wiki.city
Großalmerode	Wiki.city
Groß-Bieberau	Wiki.city
Großbottwar	Wiki.city
Großbreitenbach	Wiki.city
Großenehrich	Wiki.city
Großenhain	Wiki.city
Groß-Gerau	Wiki.city
Großräschen	Wiki.city
Großröhrsdorf	Wiki.city
Großschirma	Wiki.city
Groß-Umstadt	Wiki.city
Grünberg	Wiki.city
Grünhain-Beierfeld	Wiki.city
Grünsfeld	Wiki.city
Grünstadt	Wiki.city
Guben	Wiki.city
Gudensberg	Wiki.city
Güglingen	Wiki.city
Gummersbach	Wiki.city
Gundelfingen an der Donau	Wiki.city
Gundelsheim	Wiki.city
Günzburg	Wiki.city
Gunzenhausen	Wiki.city
Güsten	Wiki.city
Güstrow	Wiki.city
Gütersloh	Wiki.city
Gützkow	Wiki.city
Haan	Wiki.city
Hachenburg	Wiki.city
Hadamar	Wiki.city
Hagen	Wiki.city
Hagenbach	Wiki.city
Hagenow	Wiki.city
Haiger	Wiki.city
Haigerloch	Wiki.city
Hainichen	Wiki.city
Haiterbach	Wiki.city
Halberstadt	Wiki.city
Haldensleben	Wiki.city
Halle	Wiki.city
Halle (Westf.)	Wiki.city
Hallenberg	Wiki.city
Hallstadt	Wiki.city
Haltern am See	Wiki.city
Halver	Wiki.city
Hamburg, Freie und Hansestadt	Wiki.city
Hameln	Wiki.city
Hamm	Wiki.city
Hammelburg	Wiki.city
Hamminkeln	Wiki.city
Hanau	Wiki.city
Hannover	Wiki.city
Hann. Münden	Wiki.city
Harburg	Wiki.city
Hardegsen	Wiki.city
Haren	Wiki.city
Harsewinkel	Wiki.city
Hartenstein	Wiki.city
Hartha	Wiki.city
Harzgerode	Wiki.city
Haselünne	Wiki.city
Haslach im Kinzigtal	Wiki.city
Haßfurt	Wiki.city
Hattersheim am Main	Wiki.city
Hattingen	Wiki.city
Hatzfeld	Wiki.city
Hausach	Wiki.city
Hauzenberg	Wiki.city
Havelberg	Wiki.city
Havelsee	Wiki.city
Hayingen	Wiki.city
Hechingen	Wiki.city
Hecklingen	Wiki.city
Heide	Wiki.city
Heideck	Wiki.city
Heidelberg	Wiki.city
Heidenau	Wiki.city
Heidenheim an der Brenz	Wiki.city
Heilbad Heiligenstadt	Wiki.city
Heilbronn	Wiki.city
Heiligenhafen	Wiki.city
Heiligenhaus	Wiki.city
Heilsbronn	Wiki.city
Heimbach	Wiki.city
Heimsheim	Wiki.city
Heinsberg	Wiki.city
Heitersheim	Wiki.city
Heldrungen	Wiki.city
Helmbrechts	Wiki.city
Helmstedt	Wiki.city
Hemau	Wiki.city
Hemer	Wiki.city
Hemmingen	Wiki.city
Hemmoor	Wiki.city
Hemsbach	Wiki.city
Hennef	Wiki.city
Hennigsdorf	Wiki.city
Heppenheim	Wiki.city
Herbolzheim	Wiki.city
Herborn	Wiki.city
Herbrechtingen	Wiki.city
Herbstein	Wiki.city
Herdecke	Wiki.city
Herdorf	Wiki.city
Herford	Wiki.city
Heringen/Helme	Wiki.city
Heringen	Wiki.city
Hermeskeil	Wiki.city
Hermsdorf	Wiki.city
Herne	Wiki.city
Herrenberg	Wiki.city
Herrieden	Wiki.city
Herrnhut	Wiki.city
Hersbruck	Wiki.city
Herten	Wiki.city
Herzberg am Harz	Wiki.city
Herzberg	Wiki.city
Herzogenaurach	Wiki.city
Herzogenrath	Wiki.city
Hessisch Lichtenau	Wiki.city
Hessisch Oldendorf	Wiki.city
Hettingen	Wiki.city
Hettstedt	Wiki.city
Heubach	Wiki.city
Heusenstamm	Wiki.city
Hilchenbach	Wiki.city
Hildburghausen	Wiki.city
Hilden	Wiki.city
Hildesheim	Wiki.city
Hillesheim	Wiki.city
Hilpoltstein	Wiki.city
Hirschau	Wiki.city
Hirschberg	Wiki.city
Hirschhorn	Wiki.city
Hitzacker	Wiki.city
Hochheim am Main	Wiki.city
Höchstadt an der Aisch	Wiki.city
Höchstädt an der Donau	Wiki.city
Hockenheim	Wiki.city
Hof	Wiki.city
Hofgeismar	Wiki.city
Hofheim am Taunus	Wiki.city
Hofheim in Unterfranken	Wiki.city
Hohenberg an der Eger	Wiki.city
Hohenleuben	Wiki.city
Hohenmölsen	Wiki.city
Hohen Neuendorf	Wiki.city
Hohenstein-Ernstthal	Wiki.city
Hohnstein	Wiki.city
Höhr-Grenzhausen	Wiki.city
Hollfeld	Wiki.city
Holzgerlingen	Wiki.city
Holzminden	Wiki.city
Homberg	Wiki.city
Homberg	Wiki.city
Homburg	Wiki.city
Horb am Neckar	Wiki.city
Hornbach	Wiki.city
Horn-Bad Meinberg	Wiki.city
Hornberg	Wiki.city
Hörstel	Wiki.city
Horstmar	Wiki.city
Höxter	Wiki.city
Hoya	Wiki.city
Hoyerswerda	Wiki.city
Hückelhoven	Wiki.city
Hückeswagen	Wiki.city
Hüfingen	Wiki.city
Hünfeld	Wiki.city
Hungen	Wiki.city
Hürth	Wiki.city
Husum	Wiki.city
Ibbenbüren	Wiki.city
Ichenhausen	Wiki.city
Idar-Oberstein	Wiki.city
Idstein	Wiki.city
Illertissen	Wiki.city
Ilmenau	Wiki.city
Ilsenburg	Wiki.city
Ilshofen	Wiki.city
Immenhausen	Wiki.city
Immenstadt im Allgäu	Wiki.city
Ingelfingen	Wiki.city
Ingelheim am Rhein	Wiki.city
Ingolstadt	Wiki.city
Iphofen	Wiki.city
Iserlohn	Wiki.city
Isny im Allgäu	Wiki.city
Isselburg	Wiki.city
Itzehoe	Wiki.city
Jarmen	Wiki.city
Jena	Wiki.city
Jerichow	Wiki.city
Jessen	Wiki.city
Jever	Wiki.city
Joachimsthal	Wiki.city
Johanngeorgenstadt	Wiki.city
Jöhstadt	Wiki.city
Jülich	Wiki.city
Jüterbog	Wiki.city
Kaarst	Wiki.city
Kahla	Wiki.city
Kaisersesch	Wiki.city
Kaiserslautern	Wiki.city
Kalbe	Wiki.city
Kalkar	Wiki.city
Kaltenkirchen	Wiki.city
Kaltennordheim	Wiki.city
Kamen	Wiki.city
Kamenz	Wiki.city
Kamp-Lintfort	Wiki.city
Kandel	Wiki.city
Kandern	Wiki.city
Kappeln	Wiki.city
Karben	Wiki.city
Karlsruhe	Wiki.city
Karlstadt	Wiki.city
Kassel	Wiki.city
Kastellaun	Wiki.city
Katzenelnbogen	Wiki.city
Kaub	Wiki.city
Kaufbeuren	Wiki.city
Kehl	Wiki.city
Kelbra	Wiki.city
Kelheim	Wiki.city
Kelkheim	Wiki.city
Kellinghusen	Wiki.city
Kelsterbach	Wiki.city
Kemberg	Wiki.city
Kemnath	Wiki.city
Kempen	Wiki.city
Kempten	Wiki.city
Kenzingen	Wiki.city
Kerpen	Wiki.city
Ketzin/Havel	Wiki.city
Kevelaer	Wiki.city
Kiel	Wiki.city
Kierspe	Wiki.city
Kindelbrück	Wiki.city
Kirchberg	Wiki.city
Kirchberg an der Jagst	Wiki.city
Kirchberg	Wiki.city
Kirchen	Wiki.city
Kirchenlamitz	Wiki.city
Kirchhain	Wiki.city
Kirchheimbolanden	Wiki.city
Kirchheim unter Teck	Wiki.city
Kirn	Wiki.city
Kirtorf	Wiki.city
Kitzingen	Wiki.city
Kitzscher	Wiki.city
Kleve	Wiki.city
Klingenberg am Main	Wiki.city
Klingenthal	Wiki.city
Klötze	Wiki.city
Klütz	Wiki.city
Knittlingen	Wiki.city
Koblenz	Wiki.city
Kohren-Sahlis	Wiki.city
Kolbermoor	Wiki.city
Kölleda	Wiki.city
Köln	Wiki.city
Königsberg in Bayern	Wiki.city
Königsbrück	Wiki.city
Königsbrunn	Wiki.city
Königsee-Rottenbach	Wiki.city
Königslutter am Elm	Wiki.city
Königstein im Taunus	Wiki.city
Königstein	Wiki.city
Königswinter	Wiki.city
Königs Wusterhausen	Wiki.city
Könnern	Wiki.city
Konstanz	Wiki.city
Konz	Wiki.city
Korbach	Wiki.city
Korntal-Münchingen	Wiki.city
Kornwestheim	Wiki.city
Korschenbroich	Wiki.city
Köthen	Wiki.city
Kraichtal	Wiki.city
Krakow am See	Wiki.city
Kranichfeld	Wiki.city
Krautheim	Wiki.city
Krefeld	Wiki.city
Kremmen	Wiki.city
Krempe	Wiki.city
Kreuztal	Wiki.city
Kronach	Wiki.city
Kronberg im Taunus	Wiki.city
Kröpelin	Wiki.city
Kroppenstedt	Wiki.city
Krumbach	Wiki.city
Kühlungsborn	Wiki.city
Kulmbach	Wiki.city
Külsheim	Wiki.city
Künzelsau	Wiki.city
Kupferberg	Wiki.city
Kuppenheim	Wiki.city
Kusel	Wiki.city
Kyllburg	Wiki.city
Kyritz	Wiki.city
Laage	Wiki.city
Laatzen	Wiki.city
Ladenburg	Wiki.city
Lage	Wiki.city
Lahnstein	Wiki.city
Lahr/Schwarzwald	Wiki.city
Laichingen	Wiki.city
Lambrecht	Wiki.city
Lampertheim	Wiki.city
Landau an der Isar	Wiki.city
Landau in der Pfalz	Wiki.city
Landsberg am Lech	Wiki.city
Landsberg	Wiki.city
Landshut	Wiki.city
Landstuhl	Wiki.city
Langelsheim	Wiki.city
Langen	Wiki.city
Langenau	Wiki.city
Langenburg	Wiki.city
Langenfeld	Wiki.city
Langenhagen	Wiki.city
Langenselbold	Wiki.city
Langenzenn	Wiki.city
Langewiesen	Wiki.city
Lassan	Wiki.city
Laubach	Wiki.city
Laucha an der Unstrut	Wiki.city
Lauchhammer	Wiki.city
Lauchheim	Wiki.city
Lauda-Königshofen	Wiki.city
Lauenburg/Elbe	Wiki.city
Lauf an der Pegnitz	Wiki.city
Laufen	Wiki.city
Laufenburg	Wiki.city
Lauffen am Neckar	Wiki.city
Lauingen	Wiki.city
Laupheim	Wiki.city
Lauscha	Wiki.city
Lauta	Wiki.city
Lauter-Bernsbach	Wiki.city
Lauterbach	Wiki.city
Lauterecken	Wiki.city
Lauterstein	Wiki.city
Lebach	Wiki.city
Lebus	Wiki.city
Leer	Wiki.city
Lehesten	Wiki.city
Lehrte	Wiki.city
Leichlingen	Wiki.city
Leimen	Wiki.city
Leinefelde-Worbis	Wiki.city
Leinfelden-Echterdingen	Wiki.city
Leipheim	Wiki.city
Leipzig	Wiki.city
Leisnig	Wiki.city
Lemgo	Wiki.city
Lengenfeld	Wiki.city
Lengerich	Wiki.city
Lennestadt	Wiki.city
Lenzen	Wiki.city
Leonberg	Wiki.city
Leun	Wiki.city
Leuna	Wiki.city
Leutenberg	Wiki.city
Leutershausen	Wiki.city
Leutkirch im Allgäu	Wiki.city
Leverkusen	Wiki.city
Lich	Wiki.city
Lichtenau	Wiki.city
Lichtenau	Wiki.city
Lichtenberg	Wiki.city
Lichtenfels	Wiki.city
Lichtenfels	Wiki.city
Lichtenstein/Sa.	Wiki.city
Liebenau	Wiki.city
Liebenwalde	Wiki.city
Lieberose	Wiki.city
Liebstadt	Wiki.city
Limbach-Oberfrohna	Wiki.city
Limburg an der Lahn	Wiki.city
Lindau	Wiki.city
Linden	Wiki.city
Lindenberg im Allgäu	Wiki.city
Lindenfels	Wiki.city
Lindow	Wiki.city
Lingen	Wiki.city
Linnich	Wiki.city
Linz am Rhein	Wiki.city
Lippstadt	Wiki.city
Löbau	Wiki.city
Löffingen	Wiki.city
Lohmar	Wiki.city
Lohne	Wiki.city
Löhne	Wiki.city
Lohr am Main	Wiki.city
Loitz	Wiki.city
Lollar	Wiki.city
Lommatzsch	Wiki.city
Löningen	Wiki.city
Lorch	Wiki.city
Lorch	Wiki.city
Lörrach	Wiki.city
Lorsch	Wiki.city
Lößnitz	Wiki.city
Löwenstein	Wiki.city
Lübbecke	Wiki.city
Lübben	Wiki.city
Lübbenau/Spreewald	Wiki.city
Lübeck, Hansestadt	Wiki.city
Lübtheen	Wiki.city
Lübz	Wiki.city
Lüchow	Wiki.city
Lucka	Wiki.city
Luckau	Wiki.city
Luckenwalde	Wiki.city
Lüdenscheid	Wiki.city
Lüdinghausen	Wiki.city
Ludwigsburg	Wiki.city
Ludwigsfelde	Wiki.city
Ludwigshafen am Rhein	Wiki.city
Ludwigslust	Wiki.city
Ludwigsstadt	Wiki.city
Lugau/Erzgeb.	Wiki.city
Lügde	Wiki.city
Lüneburg, Hansestadt	Wiki.city
Lünen	Wiki.city
Lunzenau	Wiki.city
Lütjenburg	Wiki.city
Lützen	Wiki.city
Lychen	Wiki.city
Magdala	Wiki.city
Magdeburg	Wiki.city
Mahlberg	Wiki.city
Mainbernheim	Wiki.city
Mainburg	Wiki.city
Maintal	Wiki.city
Mainz	Wiki.city
Malchin	Wiki.city
Malchow	Wiki.city
Mannheim	Wiki.city
Manderscheid	Wiki.city
Mansfeld	Wiki.city
Marbach am Neckar	Wiki.city
Marburg	Wiki.city
Marienberg	Wiki.city
Marienmünster	Wiki.city
Markdorf	Wiki.city
Markgröningen	Wiki.city
Märkisch Buchholz	Wiki.city
Markkleeberg	Wiki.city
Markneukirchen	Wiki.city
Markranstädt	Wiki.city
Marktbreit	Wiki.city
Marktheidenfeld	Wiki.city
Marktleuthen	Wiki.city
Marktoberdorf	Wiki.city
Marktredwitz	Wiki.city
Marktsteft	Wiki.city
Marl	Wiki.city
Marlow	Wiki.city
Marne	Wiki.city
Marsberg	Wiki.city
Maulbronn	Wiki.city
Maxhütte-Haidhof	Wiki.city
Mayen	Wiki.city
Mechernich	Wiki.city
Meckenheim	Wiki.city
Medebach	Wiki.city
Meerane	Wiki.city
Meerbusch	Wiki.city
Meersburg	Wiki.city
Meinerzhagen	Wiki.city
Meiningen	Wiki.city
Meisenheim	Wiki.city
Meißen	Wiki.city
Meldorf	Wiki.city
Melle	Wiki.city
Mellrichstadt	Wiki.city
Melsungen	Wiki.city
Memmingen	Wiki.city
Menden	Wiki.city
Mendig	Wiki.city
Mengen	Wiki.city
Meppen	Wiki.city
Merkendorf	Wiki.city
Merseburg	Wiki.city
Merzig	Wiki.city
Meschede	Wiki.city
Meßkirch	Wiki.city
Meßstetten	Wiki.city
Mettmann	Wiki.city
Metzingen	Wiki.city
Meuselwitz	Wiki.city
Meyenburg	Wiki.city
Michelstadt	Wiki.city
Miesbach	Wiki.city
Miltenberg	Wiki.city
Mindelheim	Wiki.city
Minden	Wiki.city
Mirow	Wiki.city
Mittenwalde	Wiki.city
Mitterteich	Wiki.city
Mittweida	Wiki.city
Möckern	Wiki.city
Möckmühl	Wiki.city
Moers	Wiki.city
Mölln	Wiki.city
Mönchengladbach	Wiki.city
Monheim am Rhein	Wiki.city
Monheim	Wiki.city
Monschau	Wiki.city
Montabaur	Wiki.city
Moosburg an der Isar	Wiki.city
Mörfelden-Walldorf	Wiki.city
Moringen	Wiki.city
Mosbach	Wiki.city
Mössingen	Wiki.city
Mücheln	Wiki.city
Mügeln	Wiki.city
Mühlacker	Wiki.city
Mühlberg/Elbe	Wiki.city
Mühldorf am Inn	Wiki.city
Mühlhausen/Thüringen	Wiki.city
Mühlheim am Main	Wiki.city
Mühlheim an der Donau	Wiki.city
Mülheim an der Ruhr	Wiki.city
Mülheim-Kärlich	Wiki.city
Müllheim	Wiki.city
Müllrose	Wiki.city
Münchberg	Wiki.city
Müncheberg	Wiki.city
München	Wiki.city
Münchenbernsdorf	Wiki.city
Munderkingen	Wiki.city
Münnerstadt	Wiki.city
Münsingen	Wiki.city
Munster	Wiki.city
Münster	Wiki.city
Münstermaifeld	Wiki.city
Münzenberg	Wiki.city
Murrhardt	Wiki.city
Mylau	Wiki.city
Nabburg	Wiki.city
Nagold	Wiki.city
Naila	Wiki.city
Nassau	Wiki.city
Nastätten	Wiki.city
Nauen	Wiki.city
Naumburg	Wiki.city
Naumburg	Wiki.city
Naunhof	Wiki.city
Nebra	Wiki.city
Neckarbischofsheim	Wiki.city
Neckargemünd	Wiki.city
Neckarsteinach	Wiki.city
Neckarsulm	Wiki.city
Neresheim	Wiki.city
Netphen	Wiki.city
Nettetal	Wiki.city
Netzschkau	Wiki.city
Neu-Anspach	Wiki.city
Neubrandenburg	Wiki.city
Neubukow	Wiki.city
Neubulach	Wiki.city
Neuburg an der Donau	Wiki.city
Neudenau	Wiki.city
Neuenbürg	Wiki.city
Neuenburg am Rhein	Wiki.city
Neuenhaus	Wiki.city
Neuenrade	Wiki.city
Neuenstadt am Kocher	Wiki.city
Neuenstein	Wiki.city
Neuerburg	Wiki.city
Neuffen	Wiki.city
Neuhaus am Rennweg	Wiki.city
Neu-Isenburg	Wiki.city
Neukalen	Wiki.city
Neukirchen	Wiki.city
Neukirchen-Vluyn	Wiki.city
Neukloster	Wiki.city
Neumark	Wiki.city
Neumarkt in der Oberpfalz	Wiki.city
Neumarkt-Sankt Veit	Wiki.city
Neumünster	Wiki.city
Neunburg vorm Wald	Wiki.city
Neunkirchen	Wiki.city
Neuötting	Wiki.city
Neuruppin	Wiki.city
Neusalza-Spremberg	Wiki.city
Neusäß	Wiki.city
Neuss	Wiki.city
Neustadt an der Aisch	Wiki.city
Neustadt an der Donau	Wiki.city
Neustadt an der Waldnaab	Wiki.city
Neustadt am Kulm	Wiki.city
Neustadt am Rübenberge	Wiki.city
Neustadt an der Orla	Wiki.city
Neustadt an der Weinstraße	Wiki.city
Neustadt bei Coburg	Wiki.city
Neustadt	Wiki.city
Neustadt-Glewe	Wiki.city
Neustadt	Wiki.city
Neustadt in Holstein	Wiki.city
Neustadt in Sachsen	Wiki.city
Neustrelitz	Wiki.city
Neutraubling	Wiki.city
Neu-Ulm	Wiki.city
Neuwied	Wiki.city
Nidda	Wiki.city
Niddatal	Wiki.city
Nidderau	Wiki.city
Nideggen	Wiki.city
Niebüll	Wiki.city
Niedenstein	Wiki.city
Niederkassel	Wiki.city
Niedernhall	Wiki.city
Nieder-Olm	Wiki.city
Niederstetten	Wiki.city
Niederstotzingen	Wiki.city
Nieheim	Wiki.city
Niemegk	Wiki.city
Nienburg	Wiki.city
Nienburg/Weser	Wiki.city
Nierstein	Wiki.city
Niesky	Wiki.city
Nittenau	Wiki.city
Norden	Wiki.city
Nordenham	Wiki.city
Norderney	Wiki.city
Norderstedt	Wiki.city
Nordhausen	Wiki.city
Nordhorn	Wiki.city
Nördlingen	Wiki.city
Northeim	Wiki.city
Nortorf	Wiki.city
Nossen	Wiki.city
Nürnberg	Wiki.city
Nürtingen	Wiki.city
Oberasbach	Wiki.city
Oberharz am Brocken	Wiki.city
Oberhausen	Wiki.city
Oberhof	Wiki.city
Oberkirch	Wiki.city
Oberkochen	Wiki.city
Oberlungwitz	Wiki.city
Obermoschel	Wiki.city
Obernburg am Main	Wiki.city
Oberndorf am Neckar	Wiki.city
Obernkirchen	Wiki.city
Ober-Ramstadt	Wiki.city
Oberriexingen	Wiki.city
Obertshausen	Wiki.city
Oberursel	Wiki.city
Oberviechtach	Wiki.city
Oberweißbach/Thür. Wald	Wiki.city
Oberwesel	Wiki.city
Oberwiesenthal	Wiki.city
Ochsenfurt	Wiki.city
Ochsenhausen	Wiki.city
Ochtrup	Wiki.city
Oderberg	Wiki.city
Oebisfelde-Weferlingen	Wiki.city
Oederan	Wiki.city
Oelde	Wiki.city
Oelsnitz/Erzgeb.	Wiki.city
Oelsnitz/Vogtl.	Wiki.city
Oer-Erkenschwick	Wiki.city
Oerlinghausen	Wiki.city
Oestrich-Winkel	Wiki.city
Oettingen in Bayern	Wiki.city
Offenbach am Main	Wiki.city
Offenburg	Wiki.city
Ohrdruf	Wiki.city
Öhringen	Wiki.city
Olbernhau	Wiki.city
Olching	Wiki.city
Oldenburg	Wiki.city
Oldenburg in Holstein	Wiki.city
Olfen	Wiki.city
Olpe	Wiki.city
Olsberg	Wiki.city
Oppenau	Wiki.city
Oppenheim	Wiki.city
Oranienbaum-Wörlitz	Wiki.city
Oranienburg	Wiki.city
Orlamünde	Wiki.city
Ornbau	Wiki.city
Ortenberg	Wiki.city
Ortrand	Wiki.city
Oschatz	Wiki.city
Oschersleben	Wiki.city
Osnabrück	Wiki.city
Osterburg	Wiki.city
Osterburken	Wiki.city
Osterfeld	Wiki.city
Osterhofen	Wiki.city
Osterholz-Scharmbeck	Wiki.city
Osterode am Harz	Wiki.city
Osterwieck	Wiki.city
Ostfildern	Wiki.city
Ostheim vor der Rhön	Wiki.city
Osthofen	Wiki.city
Östringen	Wiki.city
Ostritz	Wiki.city
Otterberg	Wiki.city
Otterndorf	Wiki.city
Ottweiler	Wiki.city
Overath	Wiki.city
Owen	Wiki.city
Paderborn	Wiki.city
Papenburg	Wiki.city
Pappenheim	Wiki.city
Parchim	Wiki.city
Parsberg	Wiki.city
Pasewalk	Wiki.city
Passau	Wiki.city
Pattensen	Wiki.city
Pausa-Mühltroff	Wiki.city
Pegau	Wiki.city
Pegnitz	Wiki.city
Peine	Wiki.city
Peitz	Wiki.city
Penig	Wiki.city
Penkun	Wiki.city
Penzberg	Wiki.city
Penzlin	Wiki.city
Perleberg	Wiki.city
Petershagen	Wiki.city
Pfaffenhofen an der Ilm	Wiki.city
Pfarrkirchen	Wiki.city
Pforzheim	Wiki.city
Pfreimd	Wiki.city
Pfullendorf	Wiki.city
Pfullingen	Wiki.city
Pfungstadt	Wiki.city
Philippsburg	Wiki.city
Pinneberg	Wiki.city
Pirmasens	Wiki.city
Pirna	Wiki.city
Plattling	Wiki.city
Plau am See	Wiki.city
Plaue	Wiki.city
Plauen	Wiki.city
Plettenberg	Wiki.city
Pleystein	Wiki.city
Plochingen	Wiki.city
Plön	Wiki.city
Pockau-Lengefeld	Wiki.city
Pocking	Wiki.city
Pohlheim	Wiki.city
Polch	Wiki.city
Porta Westfalica	Wiki.city
Pößneck	Wiki.city
Potsdam	Wiki.city
Pottenstein	Wiki.city
Preetz	Wiki.city
Premnitz	Wiki.city
Prenzlau	Wiki.city
Pressath	Wiki.city
Preußisch Oldendorf	Wiki.city
Prichsenstadt	Wiki.city
Pritzwalk	Wiki.city
Prüm	Wiki.city
Puchheim	Wiki.city
Pulheim	Wiki.city
Pulsnitz	Wiki.city
Putbus	Wiki.city
Putlitz	Wiki.city
Püttlingen	Wiki.city
Quakenbrück	Wiki.city
Quedlinburg	Wiki.city
Querfurt	Wiki.city
Quickborn	Wiki.city
Rabenau	Wiki.city
Radeberg	Wiki.city
Radebeul	Wiki.city
Radeburg	Wiki.city
Radevormwald	Wiki.city
Radolfzell am Bodensee	Wiki.city
Raguhn-Jeßnitz	Wiki.city
Rahden	Wiki.city
Rain	Wiki.city
Ramstein-Miesenbach	Wiki.city
Ranis	Wiki.city
Ransbach-Baumbach	Wiki.city
Rastatt	Wiki.city
Rastenberg	Wiki.city
Rathenow	Wiki.city
Ratingen	Wiki.city
Ratzeburg	Wiki.city
Rauenberg	Wiki.city
Raunheim	Wiki.city
Rauschenberg	Wiki.city
Ravensburg	Wiki.city
Ravenstein	Wiki.city
Recklinghausen	Wiki.city
Rees	Wiki.city
Regen	Wiki.city
Regensburg	Wiki.city
Regis-Breitingen	Wiki.city
Rehau	Wiki.city
Rehburg-Loccum	Wiki.city
Rehna	Wiki.city
Reichelsheim	Wiki.city
Reichenbach im Vogtland	Wiki.city
Reichenbach/O.L.	Wiki.city
Reinbek	Wiki.city
Reinfeld	Wiki.city
Reinheim	Wiki.city
Remagen	Wiki.city
Remda-Teichel	Wiki.city
Remscheid	Wiki.city
Remseck am Neckar	Wiki.city
Renchen	Wiki.city
Rendsburg	Wiki.city
Rennerod	Wiki.city
Renningen	Wiki.city
Rerik	Wiki.city
Rethem	Wiki.city
Reutlingen	Wiki.city
Rheda-Wiedenbrück	Wiki.city
Rhede	Wiki.city
Rheinau	Wiki.city
Rheinbach	Wiki.city
Rheinberg	Wiki.city
Rheinböllen	Wiki.city
Rheine	Wiki.city
Rheinfelden	Wiki.city
Rheinsberg	Wiki.city
Rheinstetten	Wiki.city
Rhens	Wiki.city
Rhinow	Wiki.city
Ribnitz-Damgarten	Wiki.city
Richtenberg	Wiki.city
Riedenburg	Wiki.city
Riedlingen	Wiki.city
Riedstadt	Wiki.city
Rieneck	Wiki.city
Riesa	Wiki.city
Rietberg	Wiki.city
Rinteln	Wiki.city
Röbel/Müritz	Wiki.city
Rochlitz	Wiki.city
Rockenhausen	Wiki.city
Rodalben	Wiki.city
Rodenberg	Wiki.city
Rödental	Wiki.city
Rödermark	Wiki.city
Rodewisch	Wiki.city
Rodgau	Wiki.city
Roding	Wiki.city
Römhild	Wiki.city
Romrod	Wiki.city
Ronneburg	Wiki.city
Ronnenberg	Wiki.city
Rosbach vor der Höhe	Wiki.city
Rosenfeld	Wiki.city
Rosenheim	Wiki.city
Rosenthal	Wiki.city
Rösrath	Wiki.city
Roßleben	Wiki.city
Roßwein	Wiki.city
Rostock, Hansestadt	Wiki.city
Rotenburg an der Fulda	Wiki.city
Rotenburg	Wiki.city
Roth	Wiki.city
Rötha	Wiki.city
Röthenbach an der Pegnitz	Wiki.city
Rothenburg/O.L.	Wiki.city
Rothenburg ob der Tauber	Wiki.city
Rothenfels	Wiki.city
Rottenburg am Neckar	Wiki.city
Rottenburg a.d.Laaber	Wiki.city
Röttingen	Wiki.city
Rottweil	Wiki.city
Rötz	Wiki.city
Rüdesheim am Rhein	Wiki.city
Rudolstadt	Wiki.city
Ruhla	Wiki.city
Ruhland	Wiki.city
Runkel	Wiki.city
Rüsselsheim	Wiki.city
Rutesheim	Wiki.city
Rüthen	Wiki.city
Saalburg-Ebersdorf	Wiki.city
Saalfeld/Saale	Wiki.city
Saarbrücken	Wiki.city
Saarburg	Wiki.city
Saarlouis	Wiki.city
Sachsenhagen	Wiki.city
Sachsenheim	Wiki.city
Salzgitter	Wiki.city
Salzkotten	Wiki.city
Salzwedel, Hansestadt	Wiki.city
Sandau	Wiki.city
Sandersdorf-Brehna	Wiki.city
Sangerhausen	Wiki.city
Sankt Augustin	Wiki.city
Sankt Goar	Wiki.city
Sankt Goarshausen	Wiki.city
Sarstedt	Wiki.city
Sassenberg	Wiki.city
Sassnitz	Wiki.city
Sayda	Wiki.city
Schalkau	Wiki.city
Schauenstein	Wiki.city
Scheer	Wiki.city
Scheibenberg	Wiki.city
Scheinfeld	Wiki.city
Schelklingen	Wiki.city
Schenefeld	Wiki.city
Scheßlitz	Wiki.city
Schieder-Schwalenberg	Wiki.city
Schifferstadt	Wiki.city
Schillingsfürst	Wiki.city
Schiltach	Wiki.city
Schirgiswalde-Kirschau	Wiki.city
Schkeuditz	Wiki.city
Schkölen	Wiki.city
Schleiden	Wiki.city
Schleiz	Wiki.city
Schleswig	Wiki.city
Schlettau	Wiki.city
Schleusingen	Wiki.city
Schlieben	Wiki.city
Schlitz	Wiki.city
Schloß Holte-Stukenbrock	Wiki.city
Schlotheim	Wiki.city
Schlüchtern	Wiki.city
Schlüsselfeld	Wiki.city
Schmalkalden	Wiki.city
Schmallenberg	Wiki.city
Schmölln	Wiki.city
Schnackenburg	Wiki.city
Schnaittenbach	Wiki.city
Schneeberg	Wiki.city
Schneverdingen	Wiki.city
Schömberg	Wiki.city
Schönau	Wiki.city
Schönau im Schwarzwald	Wiki.city
Schönberg	Wiki.city
Schönebeck	Wiki.city
Schöneck/Vogtl.	Wiki.city
Schönewalde	Wiki.city
Schongau	Wiki.city
Schöningen	Wiki.city
Schönsee	Wiki.city
Schönwald	Wiki.city
Schopfheim	Wiki.city
Schöppenstedt	Wiki.city
Schorndorf	Wiki.city
Schortens	Wiki.city
Schotten	Wiki.city
Schramberg	Wiki.city
Schraplau	Wiki.city
Schriesheim	Wiki.city
Schrobenhausen	Wiki.city
Schrozberg	Wiki.city
Schüttorf	Wiki.city
Schwaan	Wiki.city
Schwabach	Wiki.city
Schwäbisch Gmünd	Wiki.city
Schwäbisch Hall	Wiki.city
Schwabmünchen	Wiki.city
Schwaigern	Wiki.city
Schwalbach am Taunus	Wiki.city
Schwalmstadt	Wiki.city
Schwandorf	Wiki.city
Schwanebeck	Wiki.city
Schwarzenbach am Wald	Wiki.city
Schwarzenbach an der Saale	Wiki.city
Schwarzenbek	Wiki.city
Schwarzenberg/Erzgeb.	Wiki.city
Schwarzenborn	Wiki.city
Schwarzheide	Wiki.city
Schwedt/Oder	Wiki.city
Schweich	Wiki.city
Schweinfurt	Wiki.city
Schwelm	Wiki.city
Schwentinental	Wiki.city
Schwerin	Wiki.city
Schwerte	Wiki.city
Schwetzingen	Wiki.city
Sebnitz	Wiki.city
Seehausen	Wiki.city
Seeland	Wiki.city
Seelow	Wiki.city
Seelze	Wiki.city
Seesen	Wiki.city
Sehnde	Wiki.city
Seifhennersdorf	Wiki.city
Selb	Wiki.city
Selbitz	Wiki.city
Seligenstadt	Wiki.city
Selm	Wiki.city
Selters	Wiki.city
Senden	Wiki.city
Sendenhorst	Wiki.city
Senftenberg	Wiki.city
Seßlach	Wiki.city
Siegburg	Wiki.city
Siegen	Wiki.city
Sigmaringen	Wiki.city
Simbach am Inn	Wiki.city
Simmern/Hunsrück	Wiki.city
Sindelfingen	Wiki.city
Singen	Wiki.city
Sinsheim	Wiki.city
Sinzig	Wiki.city
Soest	Wiki.city
Solingen	Wiki.city
Solms	Wiki.city
Soltau	Wiki.city
Sömmerda	Wiki.city
Sondershausen	Wiki.city
Sonneberg	Wiki.city
Sonnewalde	Wiki.city
Sonthofen	Wiki.city
Sontra	Wiki.city
Spaichingen	Wiki.city
Spalt	Wiki.city
Spangenberg	Wiki.city
Speicher	Wiki.city
Spenge	Wiki.city
Speyer	Wiki.city
Spremberg	Wiki.city
Springe	Wiki.city
Sprockhövel	Wiki.city
Stade	Wiki.city
Stadtallendorf	Wiki.city
Stadtbergen	Wiki.city
Stadthagen	Wiki.city
Stadtilm	Wiki.city
Stadtlengsfeld	Wiki.city
Stadtlohn	Wiki.city
Stadtoldendorf	Wiki.city
Stadtprozelten	Wiki.city
Stadtroda	Wiki.city
Stadtsteinach	Wiki.city
Stadt Wehlen	Wiki.city
Starnberg	Wiki.city
Staßfurt	Wiki.city
Staufen im Breisgau	Wiki.city
Staufenberg	Wiki.city
Stavenhagen	Wiki.city
St. Blasien	Wiki.city
Stein	Wiki.city
Steinach	Wiki.city
Steinau an der Straße	Wiki.city
Steinbach-Hallenberg	Wiki.city
Steinbach	Wiki.city
Steinfurt	Wiki.city
Steinheim an der Murr	Wiki.city
Steinheim	Wiki.city
Stendal	Wiki.city
Sternberg	Wiki.city
St. Ingbert	Wiki.city
St. Georgen im Schwarzwald	Wiki.city
Stockach	Wiki.city
Stolberg	Wiki.city
Stollberg/Erzgeb.	Wiki.city
Stolpen	Wiki.city
Storkow	Wiki.city
Stößen	Wiki.city
Straelen	Wiki.city
Stralsund, Hansestadt	Wiki.city
Strasburg	Wiki.city
Straubing	Wiki.city
Strausberg	Wiki.city
Strehla	Wiki.city
Stromberg	Wiki.city
Stühlingen	Wiki.city
Stutensee	Wiki.city
Stuttgart	Wiki.city
St. Wendel	Wiki.city
Suhl	Wiki.city
Sulingen	Wiki.city
Sulz am Neckar	Wiki.city
Sulzbach/Saar	Wiki.city
Sulzbach-Rosenberg	Wiki.city
Sulzburg	Wiki.city
Sundern	Wiki.city
Südliches Anhalt	Wiki.city
Süßen	Wiki.city
Syke	Wiki.city
Tambach-Dietharz	Wiki.city
Tangerhütte	Wiki.city
Tangermünde	Wiki.city
Tann	Wiki.city
Tanna	Wiki.city
Tauberbischofsheim	Wiki.city
Taucha	Wiki.city
Taunusstein	Wiki.city
Tecklenburg	Wiki.city
Tegernsee	Wiki.city
Telgte	Wiki.city
Teltow	Wiki.city
Templin	Wiki.city
Tengen	Wiki.city
Tessin	Wiki.city
Teterow	Wiki.city
Tettnang	Wiki.city
Teublitz	Wiki.city
Teuchern	Wiki.city
Teupitz	Wiki.city
Teuschnitz	Wiki.city
Thale	Wiki.city
Thalheim/Erzgeb.	Wiki.city
Thannhausen	Wiki.city
Tharandt	Wiki.city
Themar	Wiki.city
Thum	Wiki.city
Tirschenreuth	Wiki.city
Titisee-Neustadt	Wiki.city
Tittmoning	Wiki.city
Todtnau	Wiki.city
Töging am Inn	Wiki.city
Tönisvorst	Wiki.city
Tönning	Wiki.city
Torgau	Wiki.city
Torgelow	Wiki.city
Tornesch	Wiki.city
Traben-Trarbach	Wiki.city
Traunreut	Wiki.city
Traunstein	Wiki.city
Trebbin	Wiki.city
Trebsen/Mulde	Wiki.city
Treffurt	Wiki.city
Trendelburg	Wiki.city
Treuchtlingen	Wiki.city
Treuen	Wiki.city
Treuenbrietzen	Wiki.city
Triberg im Schwarzwald	Wiki.city
Tribsees	Wiki.city
Trier	Wiki.city
Triptis	Wiki.city
Trochtelfingen	Wiki.city
Troisdorf	Wiki.city
Trossingen	Wiki.city
Trostberg	Wiki.city
Tübingen	Wiki.city
Tuttlingen	Wiki.city
Twistringen	Wiki.city
Übach-Palenberg	Wiki.city
Überlingen	Wiki.city
Uebigau-Wahrenbrück	Wiki.city
Ueckermünde	Wiki.city
Uelzen	Wiki.city
Uetersen	Wiki.city
Uffenheim	Wiki.city
Uhingen	Wiki.city
Ulm	Wiki.city
Ulmen	Wiki.city
Ulrichstein	Wiki.city
Ummerstadt	Wiki.city
Unkel	Wiki.city
Unna	Wiki.city
Unterschleißheim	Wiki.city
Usedom	Wiki.city
Usingen	Wiki.city
Uslar	Wiki.city
Vacha	Wiki.city
Vaihingen an der Enz	Wiki.city
Vallendar	Wiki.city
Varel	Wiki.city
Vechta	Wiki.city
Velbert	Wiki.city
Velburg	Wiki.city
Velden	Wiki.city
Vellberg	Wiki.city
Velen	Wiki.city
Vellmar	Wiki.city
Velten	Wiki.city
Verden	Wiki.city
Veringenstadt	Wiki.city
Verl	Wiki.city
Versmold	Wiki.city
Vetschau/Spreewald	Wiki.city
Viechtach	Wiki.city
Viernheim	Wiki.city
Viersen	Wiki.city
Villingen-Schwenningen	Wiki.city
Vilsbiburg	Wiki.city
Vilseck	Wiki.city
Vilshofen an der Donau	Wiki.city
Visselhövede	Wiki.city
Vlotho	Wiki.city
Voerde	Wiki.city
Vogtsburg im Kaiserstuhl	Wiki.city
Vohburg an der Donau	Wiki.city
Vohenstrauß	Wiki.city
Vöhrenbach	Wiki.city
Vöhringen	Wiki.city
Volkach	Wiki.city
Völklingen	Wiki.city
Volkmarsen	Wiki.city
Vreden	Wiki.city
Wachenheim an der Weinstraße	Wiki.city
Wächtersbach	Wiki.city
Wadern	Wiki.city
Waghäusel	Wiki.city
Wahlstedt	Wiki.city
Waiblingen	Wiki.city
Waibstadt	Wiki.city
Waischenfeld	Wiki.city
Waldbröl	Wiki.city
Waldeck	Wiki.city
Waldenbuch	Wiki.city
Waldenburg	Wiki.city
Waldenburg	Wiki.city
Waldershof	Wiki.city
Waldheim	Wiki.city
Waldkappel	Wiki.city
Waldkirch	Wiki.city
Waldkirchen	Wiki.city
Waldkraiburg	Wiki.city
Waldmünchen	Wiki.city
Waldsassen	Wiki.city
Waldshut-Tiengen	Wiki.city
Walldorf	Wiki.city
Walldürn	Wiki.city
Wallenfels	Wiki.city
Walsrode	Wiki.city
Waltershausen	Wiki.city
Waltrop	Wiki.city
Wanfried	Wiki.city
Wangen im Allgäu	Wiki.city
Wanzleben-Börde	Wiki.city
Warburg	Wiki.city
Waren	Wiki.city
Warendorf	Wiki.city
Warin	Wiki.city
Warstein	Wiki.city
Wassenberg	Wiki.city
Wasserburg am Inn	Wiki.city
Wassertrüdingen	Wiki.city
Wasungen	Wiki.city
Wedel	Wiki.city
Weener	Wiki.city
Wegberg	Wiki.city
Wegeleben	Wiki.city
Wehr	Wiki.city
Weida	Wiki.city
Weiden in der Oberpfalz	Wiki.city
Weikersheim	Wiki.city
Weil am Rhein	Wiki.city
Weilburg	Wiki.city
Weil der Stadt	Wiki.city
Weilheim an der Teck	Wiki.city
Weilheim in Oberbayern	Wiki.city
Weimar	Wiki.city
Weingarten	Wiki.city
Weinheim	Wiki.city
Weinsberg	Wiki.city
Weinstadt	Wiki.city
Weismain	Wiki.city
Weißenberg	Wiki.city
Weißenburg in Bayern	Wiki.city
Weißenfels	Wiki.city
Weißenhorn	Wiki.city
Weißensee	Wiki.city
Weißenstadt	Wiki.city
Weißenthurm	Wiki.city
Weißwasser/O.L.	Wiki.city
Weiterstadt	Wiki.city
Welzheim	Wiki.city
Welzow	Wiki.city
Wemding	Wiki.city
Wendlingen am Neckar	Wiki.city
Werben	Wiki.city
Werdau	Wiki.city
Werder	Wiki.city
Werdohl	Wiki.city
Werl	Wiki.city
Wermelskirchen	Wiki.city
Wernau	Wiki.city
Werne	Wiki.city
Werneuchen	Wiki.city
Wernigerode	Wiki.city
Wertheim	Wiki.city
Werther (Westf.)	Wiki.city
Wertingen	Wiki.city
Wesel	Wiki.city
Wesenberg	Wiki.city
Wesselburen	Wiki.city
Wesseling	Wiki.city
Westerburg	Wiki.city
Westerstede	Wiki.city
Wetter	Wiki.city
Wetter	Wiki.city
Wettin-Löbejün	Wiki.city
Wetzlar	Wiki.city
Widdern	Wiki.city
Wiehe	Wiki.city
Wiehl	Wiki.city
Wiesbaden	Wiki.city
Wiesmoor	Wiki.city
Wiesensteig	Wiki.city
Wiesloch	Wiki.city
Wildau	Wiki.city
Wildberg	Wiki.city
Wildenfels	Wiki.city
Wildeshausen	Wiki.city
Wilhelmshaven	Wiki.city
Wilkau-Haßlau	Wiki.city
Willebadessen	Wiki.city
Willich	Wiki.city
Wilsdruff	Wiki.city
Wilster	Wiki.city
Wilthen	Wiki.city
Windischeschenbach	Wiki.city
Windsbach	Wiki.city
Winnenden	Wiki.city
Winsen	Wiki.city
Winterberg	Wiki.city
Wipperfürth	Wiki.city
Wirges	Wiki.city
Wismar, Hansestadt	Wiki.city
Wissen	Wiki.city
Witten	Wiki.city
Wittenberg	Wiki.city
Wittenberge	Wiki.city
Wittenburg	Wiki.city
Wittichenau	Wiki.city
Wittlich	Wiki.city
Wittingen	Wiki.city
Wittmund	Wiki.city
Wittstock/Dosse	Wiki.city
Witzenhausen	Wiki.city
Woldegk	Wiki.city
Wolfach	Wiki.city
Wolfenbüttel	Wiki.city
Wolfhagen	Wiki.city
Wolframs-Eschenbach	Wiki.city
Wolfratshausen	Wiki.city
Wolfsburg	Wiki.city
Wolfstein	Wiki.city
Wolgast	Wiki.city
Wolkenstein	Wiki.city
Wolmirstedt	Wiki.city
Worms	Wiki.city
Wörrstadt	Wiki.city
Wörth am Rhein	Wiki.city
Wörth an der Donau	Wiki.city
Wörth am Main	Wiki.city
Wriezen	Wiki.city
Wülfrath	Wiki.city
Wunsiedel	Wiki.city
Wunstorf	Wiki.city
Wuppertal	Wiki.city
Würselen	Wiki.city
Wurzbach	Wiki.city
Würzburg	Wiki.city
Wurzen	Wiki.city
Wustrow	Wiki.city
Wyk auf Föhr	Wiki.city
Xanten	Wiki.city
Zahna-Elster	Wiki.city
Zarrentin am Schaalsee	Wiki.city
Zehdenick	Wiki.city
Zeil am Main	Wiki.city
Zeitz	Wiki.city
Zell am Harmersbach	Wiki.city
Zell im Wiesental	Wiki.city
Zell  	Wiki.city
